11111111111111111111
1PPCCCCCCCCCCCCCCCC1
1CCCCCCCCCCCCCCCCCC1
1CCCCCCCCCCCCCCCCCC1
1CCCCCCCCCCCCCCCCCC1
1CCCCC00000CCCCCCCC1
1CCCCCCCCCCCCCCCCCC1
1CCCCCCCCCCCCCCCCCC1
11111111111111111111