11111111111111111111
1PCCCCCCCCCCCCCCCCC1
1CCCCCCCCCCCCCCCCCC1
1CCCCCCCCCCCCCCCCCC1
1CCCCCCCCCCCCCCCCCC1
1CCCCC00000CCCCCC111
1CCCCCCCCCCCCCCCC111
1CCCCCCCCCCCCCCCCCE1
11111111111111111111