11111111111111111111
1E000000000000000001
11000000000000000001
111000000CCC00000001
11000000000000000001
10000000010000000001
10000000000000000001
1P000000000000000011
11111111111111111111