11111111111111111111
1ECCCCCCCCCCCCCCCCC1
11CCCCCCCCCCCCCCCCC1
111CCCCCC000000CCCC1
11CCCCCCC000000CCCC1
1CCCCCCCC1CCCCCCCCC1
1CCCCCCCCCCCCCCCCCC1
1PCCCCCCCCCCCCCCCC11
11111111111111111111