11111111111111111111
1PCCCCCCCCCCCCCCCCC1
1CCCCCCCCCCCCCCCCCC1
1CCCCCCCCCCCCCCCCCC1
1CCCCCCCCCCCCCCCCCC1
1CCCCC00000CCCCCCCC1
1CCCCCCCCCCCCCCCCCC0
1CCCCCCCCCCCCCCCCCE1
11111111111111111111