11111111111111111111
1PCCCCCCCCCCCCCCCCC1
1CCCCCCCCCCCCCCCCCC1
1CCCCCCCCCCCCCCCCCC1
1CCCCCCCCCCCCCCCCCC1
1CCCCC00000CCCCCCCC1
1CCCCCCCCCCCCCC11111
1CCCCCCCCCCCCCC1CCE1
11111111111111111111